name	prefix	repeat	suffix
HMNR7	GCGTGGGCGTGGCCTCGGCGTGGGTGTGGCCGCTCGGGGAGGGGCCTCCCGGGGGCGGGGCCGGCCTGGTCCGCGCGGTGACGCGCCCTGCAGCCCCGAGCGAGCGAGCGAGCGAGCGAGTTGCCGAGCGCGCCCCGTCCCTCGCGCGCGATGCTCCCCTGGACGGCGCTCGGCCTGGCCCTGAGCTTGCGGCTGGCGCT	GGCGCGGAGC	GCGGTGAGTGCGGCGGGCGGCCGGGCCGGGGCTGGGGCTTCTGGTGACCGCTCTGCGCCGCTGCCCGCGCAAGGCCGTCGCTGTCCCCTGCTCCGGACGGGCGGGCGGGCTGGGAGGCTGCGGGAGCCGGGCGGGGGCGCGGGCGGAGCGTCCTGCTCACCTGAGGCTGGCGGCCCAGGTGCTCCAGGCGACACCGTCCG
SCA37	TTAACCTCCATGCTGTTCTGAATATCTCTTAGCAAAGCTGGAAAGAATGAAGCCCAGGAATGTAAACTGACTATATAAATCACACAAGGCCAGGCACAGTGGCTCACACCTATAATCCCGACACTTTGGGAGGCAGAGGCAGGTGGACCACTTTAGCCCAGGAGTTCGAGACCAGCCTGGGCAACACAGTGAGACCCTGTCTCCAC	AAAAT	TAGCCAGGCATGGTGCCATACATCTGTAATCCTAGTTACCTGGGAGGCTGACTTGGGAGGACCACTTCAGCCAGGGAGGCTGAGGCTGCAGTAAGCTGTGATGGCACTACTGCACTTCAGCCTGGGTAAAAGAGCATGACCCTGTCTCAAAAAAAACAAAAAAAAGTCACACAAAATGGTACTCTGAAAAAAGTAAGAGTTCGGAAGT
NIID	ACACCCGAGAAAGTTTCAGCCAAACTTCGGGCGGCGGCTGAGGCGGCGGCCGAGGAGCGGCGGACTCGGGGCGCGGGGAGTCGAGGCATTTGCGCCTGTGCTTCGGACCGTAGCGCCAGGGCCTGAGCCTTTGAAGCAGGAGGAGGGGAGGAGAGAGTGGGGCTCCTCTATCGGGACCCCCTCCCCATGTGGATCTGCCC	CGG	GACCGAGAAGATGCCCGCCCTGCGCCGCTCTGCTGTGGGCGCTGCTGGCGCTCTGGCTGTGCTGCGCGACCCCCGCGCATGGTGAGTATCGGGCTGAGGGGCGCTGTCCGCGGCGCCCGGGGCTGCCACCTGGGGCGACCCTTCTCCCCCTCGGTCCTTCTCTGTGTGGGAAGGCCAGGCTCGGCCGCCGGCGCGGAGCG
FAME2	GACCAGCCTAACCAACGTGGAGAAACCCTGTCTCTACTAAAAATACAAAATTAGCTGGGCACGGTGGCACATACCTGTAATCCCAGCTACTCGGGAGACTGAGGCAAGAGAATCGCTTGAACACGGGAGGCGGAGGTTGCAGGGAGCCAAGATCGTGCCATTGCACTCTAGCCTGGGCAACAAGAGCGAAACTCCGTCTC	AAAAT	AAAGCCAAGCACAACGGCTCACGCCTGTAATCCCAGACTTTGGGAGGCCGAGGTGGGCGGATCACCTGAGGTCAGGAGTTCGAGACCGGCCTGGGAAACATGGTGAAACTCCATCTCTACTAAAAATACAAAAATTAGCTGGGCATGGTGGTGGACGCCTGTAATCCCAGCTACTCGGGAGGCTGAGGCAGAAGAATCAC
FRA2A	ATTCCTGGAGCAGGGCTAAGTCGAAGCTGTCCATGGTGGGAGGTGTCAGCGTCGCCGCCGCCGCTACCGCCGCCGCCGAGGCTCGGGCCGCCCGCGCGCTGCAACGAAAGGCGCCGCTCAAGGTGCATCCCAGCCGCGCCAGAGCGGCCGCCGCCCGCCCACCGCCCACCCCCAGGTCGGGGCTCCCGACGCCCCCCGCC	CCG	CGGGAGGCGCGTGTGCGCGGGCGAGGCCGAGGCGCGCGCGCACCGTGAGCCCCGCGCCGCGCCCGCCCCGCGCGCCCCTGTACTCCCCGCGCCGCTCCTCGGGGTCCCGCGGCGCTCGCAGGCCGCGCCGCCCTGCCGCCCCTCTCTCGTGGCTTTTACGGCCCGCCCGCCCCTCAGCAGCCCTGGGGTGCCCGGGGCGG
SPD	GGGCCAGGGCCGGGGCCGGGCCAGGCCGGGCCATGAGCCGCGCCGGGAGCTGGGACATGGACGGGCTGCGGGCAGACGGCGGGGGCGCCGGTGGCGCCCCGGCCTCTTCCTCCTCCTCATCGGTGGCGGCGGCGGCGGCGTCAGGCCAGTGCCGCGGCTTTCTCTCCGCGCCTGTGTTCGCCGGGACGCATTCGGGGCG	GGC	CTCCGGCTTTGCGTACCCCGGGACCTCTGAGCGCACGGGCTCTTCCTCGTCGTCGTCCTCTTCTGCCGTTGTAGCGGCGCGCCCGGAGGCTCCCCCAGCCAAAGAGTGCCCAGCACCCACGCCTGCAGCGGCCGCTGCAGCGCCCCCGAGCGCTCCAGCGCTGGGCTACGGCTACCACTTCGGCAACGGCTACTACAGCT
GAD	CTCCGCGCACCCAGAGCCGAGAGAAATTTGACTGCCCTAATCGCCAATCAAAAGAGAGGTCGAGGATTTGAGCCAATCGCAGCGGGCGAAAGGGGCGGGCCGTCGGCGAGCGCTGAAGGTCTCTAGCCCTCCCCTGCGCTTTAGCCTCAGTGCGGAGCCTTAGGCGGAGCGAAGAGAACCGGTCGCGGCAATCCTAGCGC	GCA	CCCGCATCCGCTGCGGGAGTCCGAGCCGGAACCACACCCAAGTAGCTGCCCTTTCCTCTTCTGTCATCTCACCGCCCCACCACAGACCGCGTTCCCCGAGGAAACCGGCCGCCCACGCCCGGAGCATCCTCCCCTGTTGAGCGGGCGCTGACGGACCCGGCGGCATGATGCGGCTGCGAGGCTCGGGGATGCTGCGGGACC
AD	TCACTCGCGGTTAGGAGCTGGAGACCAGCCCGGCCAACACAGCGAAACCCCATCTCCACCAAAAAAAAAACGAAAACCAGTCAGGCGTGGCGGCGCGCGCCTGCAATCGCAGGCACTCGGCAGGCTGAGGCAGGAGAATCAGGCAGGGAGGTTGCAGTGAGCCGAGATGGCAGCAGTACCGTCCAGCTTTGGCTCGGCAT	GAGAGG	GGTCAAATTCTTATCTATCAATGTTATGCCCACTGTGCTCTCCAGCTGTGGTCTGTGAATTACTGTGGTATAACGTGACTGTTCAAATTTCACTTTTCAGGGGCTTTGACCACGACCTTTGAAGAGCTTCATTTTGAGATCAAGCCCCACGATGACTGCACAGTAGAGCAAATCTATGAGATTTTGAAAATCTACCAACT
SCA7	CCACCCGGTCCGCGGGCCGCGCACGCCGCCGGAACTCCCTGGCGCCTCCTTAAAAAACGGCCCCCGCGCGACTCTTTCCCCCTTTTTTTTGTTACATTGTAGGAGCGGAAAGAATGTCGGAGCGGGCCGCGGATGACGTCAGGGGGGAGCCGCGCCGCGCGGCGGCGGCGGCGGGCGGAGCAGCGGCCGCGGCCGCCCGG	CAG	CCGCCGCCTCCGCAGCCCCAGCGGCAGCAGCACCCGCCACCGCCGCCACGGCGCACACGGCCGGAGGACGGCGGGCCCGGCGCCGCCTCCACCTCGGCCGCCGCAATGGCGACGGTCGGGGAGCGCAGGCCTCTGCCCAGTCCTGAAGTGATGCTGGGACAGTCGTGGAATCTGTGGGTTGAGGCTTCCAAACTTCCTGG
DM2	TTTGAGACCAGTCTGGCCAACATGGCGAAACCCCGTCTCTACTAAAAATACAAAAAACAGCCGGGCATGGCGGCATGCGCCTGTAATCCCAGCTACTCAGGAGGCTGAGGCAGAAGAATCGCTTGAACCCGGGGGGTGGAGGTTGCAGTGAGCCGAGATCATACCACTGCACTCCAGCCTAGGGGACAAAGTGAGACAGA	CAGG	CAGACAGACAGACAGACAGACAGACAGACAGACAGACAGACACACACACACACACACACACACACACACACACACACTGGCAGTAATACTCATTCACTCATTCCAAGTCCAACTTAATGGACACATTTGCATGGTTATAAGGCCTATATAAGCTTTATTTTGGGCAAATAGAAGTCATTTATTTACTCACATCAAAAAAT
BPES	CGTGCAGATGGTGTGCGTGCGGATGCGGGTGGGGGTGCGGCGGAGGCGGGGGTGCGGCCGGCGGGCCTCCCAGGCCATTGTACGAGTTCACTACGCCGGGGGGCAGCGCCATGCTCTGCACGCGTGTGTACGGCCCGTACGAGGCGGCCGGGCCCGCCAGCCCCTTGACCACAGCGGCCGCGCCAGGGCTACCGGGGCCC	GCN	ATCTGGCAGGAGGCATAGGGCATGGGTGAGGGAGGCTGCGGTAGCGGCCACGAGTTGTTGAGGAAGCCAGACTGCAGGTACTTGGGGGGCGCCAGGTAGCCGTAGCCGTCGGCCCCGGCGCCCGCCACGCCGCACCCGCCTGCGGCGCCTCCGGCCCCGAAGAGCCCCTTGCCGGGCTGGAAGTGCGCGGGCGGCGGCC
FAME4	GTCTGGCTAATTTTTGTATTTTTAGTAGAGATGGATTTTCACCATGTTGGCTAGGCTGGTCTCGAACTCCTGACCTCATGATCCGCCTACCTTGCCCTCCCAAAGTGCTGGGATTACAGGCATGAGCCACTGCACCCGGCCTAAATTGTTATTTTTGTTTTAACTTTGAGTGAATACAAAATGAGTATTTTTGAGTTAGC	ATTTT	TTGAGACAGAGTCTCACCCTGTCTCCCAGGCTGGAGTGCAGTGGTACAATCTCGGCTCACTGCAACCTGCCTTCTGGGTTCAAGCGATTCTCATGCCTCAGCGTCCTGAGTAGCTGGGATTACTGGCATGAGCCACCATGCCCAGCTAATTTTTTTGTATTTTTAGTAGAGACGAGGTTTCACCATGTTGGCCAGCCTGG
HD	GGGGGCTGCCGGGACGGGTCCAAGATGGACGGCCGCTCAGGTTCTGCTTTTACCTGCGGCCCAGAGCCCCATTCATTGCCCCGGTGCTGAGCGGCGCCGCGAGTCGGCCCGAGGCCTCCGGGGACTGCCGTGCCGGGCGGGAGACCGCCATGGCGACCCTGGAAAAGCTGATGAAGGCCTTCGAGTCCCTCAAGTCCTTC	CAG	CAACAGCCGCCACCGCCGCCGCCGCCGCCGCCGCCTCCTCAGCTTCCTCAGCCGCCGCCGCAGGCACAGCCGCTGCTGCCTCAGCCGCAGCCGCCCCCGCCGCCGCCCCCGCCGCCACCCGGCCCGGCTGTGGCTGAGGAGCCGCTGCACCGACCGTGAGTTTGGGCCCGCTGCAGCTCCCTGTCCCGGCGGGTCCCAGG
CANVAS	AGCTTGGCCAATATGGTAAAACCCCATCTCTAGGAAAAATACAAAAAATTAGCTGGACATGGTGGCACGCGACTATAGTCCCAGCTACTCAGGAGGCTGAGGCAGGAGATTCACTTGAACCTGGGAGGCAGAGGTTGCAGTGAGCCGAGATTGCGCCACTGCACTCCAGTCTGGGCAACAGAGCAAGACTCTGTTTCAAA	AAAAG	AAAAAGCATGTTCTAAAGAGAATAGCAACGGTGTAGCTGGAGTATCACTTGATAAAGAGATTATGGGATTATACAGGCAAAAACACTGTCAGTTTGAATTGAAGAGGATGGAGAAAGGACAAAATGAAAGAAGGCTGTCAGACTTCTGAGATTCCAGTGACAGGACAACACAGCTATTCTTCAAGAAAAGGGAAGAATGG
CCHS	GTCGCCGCCGCCGCCGCCGCCGCAGGATTCCAGATCAGAACATACTGCTCTTCACTAAGGCGGCTTTGGCACCGTTGGGTCTTTGGAGCGAAGATAGGACGCTGGCGAAGGGACCCCCAAGCGAATCCGGGATGGAGGTGATGGGGCCGGGGCCGGGAGCCCAGCCTTGTCCAGGGCCCCCAGCCGCAGCCAGGCCTCCA	GCN	CCGCCCTTGCCGGGTTCGCCTCCCGGGCCCCCGGGCCCCGCCGCCCCCGGAGCTCCAGCCGGGCTGGGCCCGCCGCCGCCGCCTCCATTCGCCCCGCAGCTGGGGGTGGGGTTGGGATTGGGACCTGGGCCCCCAGTGCTGTCCGGGTCAGTGCTCTTGGCCTCTTTGCTCTCGTCGTCCCTGGAAGAGTCAGACTTTTT
FAME7	TAATGTGTGTGGAGTTCCATCAAATAGCACAAAGCAGATGGCCGGGAAATGTTAATTTTCTTCCCTTTTTTTAAGAGCTTAGATTGAGGTTAGAAGAAAAAAAAATGGCAACAATTAGTTATATTGATGTTGAGGGTGATTATTAAATTAGTCATTTTCTCTGTCTGGGAGTTTAGTCATACTCTCATTACTATCATAGC	TTTTA	TTACTAGAGGATATTTGCTCAGTCGGTTTTATCAAATGGCCGCTATGGGCTAAGCACTGCTATGTGTACATACTGCTGTGTATGGAAACAAAGCATCAATACTTACATTCAGGTGGTTTTACTGATAGTAAACAGATGAGGTAGGTCTATACGGAAGAGAAGAGTAAAACGCCTTGGCTTGACCCTGACCCTACTTCCCT
FAME3	AATAAAAAATGTTCTATTTGTGAAATCAGTTATTATAGGTTATTTCTTTAAAAAATGCGACTTAGGTTTTTTAAATCTGCTTAGAAATTTTTTGGTAGGAGATATTCAAAGTATGGCCAAACATAAAACTAAATTAAAAAAAAATCAGTATCACCTACTTTTGAAAACACTTATACTGTTGTGGTTCTGTTTTTTATTT	ATTTT	CCGAGATGGAGTCTTGCCCTGTTGCCCAGGCTGAAGTGCAGTGGCATGATCTCTGCTCACTGCAACCTCCACCTCCCAGGTTCAAGCGATTCTCCTGTCTCAGCCTCCTGAGTAGCTGGGATTACAGGAGCGCGCCACCTCCCTCTGCTAATTTTTGTGTTTTTAGTAGAGATGGGGTTTCGCCATGTTGGCCAGACTGG
SCA12	AATGGTGCCTTTCTGGACCCGAGCTGCAGTGGCGAGATGGCAGGGACAGGATTCAGGCTTGCCTGGCCGGAATGAGGGTGCTGGTCCCACGGGAGGGCGGCTCCGGCAGGCGGGGGTAGGGAAGCTGGCGGGGAGCTGGGCAGGGCGCTGCAGCCGGCGCCAGCGCACTCACCCTCACACCCACACGCGCGCACTCGCAG	CTG	CAGGAGGCTGGAGGCGGCTGGTGCATTAAAGGCGAGGCTCCTCCCAACCGCGTCAGCAGCCCCACGACTCTTTCCCAGCAGCAGTGGTGGCCGAGGCAGAGGCTGCGGCTGCTCTTTGCTGCAGTGGGGCGCATGCAGCCGCGAATCGGCACCTGGGCAGCAAGCGACTAGCTTGCAGGTTCAGGTGGAACGCATAGACG
SCA1	ATTGCATGACGACCTGGGAGGGGGGCCCCAGGGTGAGCGTGTGTGGGATCATCGTCTGGTGGGGGTGGAGGTGGACGGGGATGGCCGGAGGAGAGGCGGTGCGGCCGGTGTTCTGCGGAGAACTGGAAATGTGGACGTACTGGTTCTGCTGGGCTGGTGGGGGGGACCCCGGGGTGATGAGCCCCGGAGCCCTGCTGAGGT	GCT	CAGCCTTGTGTCCCGGCGTCTGGCTCAGACTGCCCATGTTGGCCAGCAGAGTGGAATAGGCCTCCAGCTGGGAGCGCTGGGATGGAGTGGTGGCCCCTGCGGCCGAGGCCACTGCACTGGTGACGGGGTTGGCGGTTGGGGGGATCAGCTGTGATGGGATGAAGCTGGCATAGGTTCCACTGTATTGGGAGGACCCAATG
CCD	CACTTCGCTAACTTGTGGCTGTTGTGATGCGTATTCCCGTAGATCCGAGCACCAGCCGGCGCTTCAGCCCCCCCTCCAGCAGCCTGCAGCCCGGCAAAATGAGCGACGTGAGCCCGGTGGTGGCTGCGCAACAGCAGCAGCAACAGCAGCAGCAGCAACAGCAGCAGCAGCAGCAGCAACAGCAGCAGCAGCAGCAGGAG	GCN	GTGCCCCGGTTGCGGCCGCCCCACGACAACCGCACCATGGTGGAGATCATCGCCGACCACCCGGCCGAACTCGTCCGCACCGACAGCCCCAACTTCCTGTGCTCGGTGCTGCCCTCGCACTGGCGCTGCAACAAGACCCTGCCCGTGGCCTTCAAGGTAAGAGGCTACACCGCCCCCCGCCCCCGGCCGGGAGCGGCGGA
SCA17	ACCTGACCTGCTGTTCCACCAAGAAAGTTCCACAAACACTTAGCAGCAGCCAGCCTAACCTGTTTTTCTCCTTGCTTTCCACAGGGTGCCATGACTCCCGGAATCCCTATCTTTAGTCCAATGATGCCTTATGGCACTGGACTGACCCCACAGCCTATTCAGAACACCAATAGTCTGTCTATTTTGGAAGAGCAACAAAG	GCA	ACAGGCAGTGGCAGCTGCAGCCGTTCAGCAGTCAACGTCCCAGCAGGCAACACAGGGAACCTCAGGCCAGGCACCACAGCTCTTCCACTCACAGACTCTCACAACTGCACCCTTGCCGGGCACCACTCCACTGTATCCCTCCCCCATGACTCCCATGACCCCCATCACTCCTGCCACGCCAGCTTCGGAGAGTTCTGGGA
HFGS	CGGCAGCCGACGGGGGCGCCTCCCCGGGGGCGCTGCTGTAGGCGGACGCGGCTCCTGGCGCCAAGGGCGCCGGGTGCGCCATCAGGTTGCGGCACTGGTTGGCCGCGGCCGCCGCCGCAGCCGCGGCCGCCGCCGCCACCGAGAAGTTGCCCCCTGCCGCCGCAGCCGCCGGGTGGGGGAAGCCCCCGCCCCCGGCCCCG	GCN	CCTTCCATGTTCTTGTTGAGCTCGTCGGCCACCAGGCCGCCGCCGTTGTCGTAGAGAAACATGACGGTGGGCTCGATCCAGCGGGGGTGGAGGAGCACGGAGGCTGTCATAGCCCGAGCCGCATGGAGAAGACCCCAGTGGCGCTGTTTTAAAAAGCCCCCAAGAAGTGAAGAGCGCGCGGCGCGGGGCCGGGGCCCGA
FRA7A	GTCTGGCGCGCCGGTGGCTGGACCGGCCCCAGGAGCCCAGTCACCGGGCGTCATTGGCTCAGGCTGCGGGGCCCTCGGCACCTTCTCCCTCCCGGGTCCACCGCGGCGGCGGCGGCGGCGGCGGCGGCGGCGGCGGCGGCGTCAGGGGGCGGAGCCTGCCGAAGCGCCCTTTGTCTGCGGAGGTGAGTGCGCGCCGGGA	GGAGGCG	GCGGCGGCGGCGGCGGCGGGCGGCGGCGGCGGCGGGAGGCGGCAGGTGGCGGGAGGGGCGGCCGCTGTCCCCGCTGTCCCCATTCCTGTCACCCGCCCCGTGTCCCTTTCAGATTTTTGGTCTTTTATAGGAAGGTCTTACCCGTTCCAATATTATAAACACATTGTCTTCTACTATCTGGGAATGACTCTGAGGCTGAAG
OPDM1	CGGGTCGCCTCAGCTTTGTTCGGTCAGCGGGGCGCGGGGACGCGGACACTTACCGTACACCCCAGCGAGGAAAAGCAAGAGCAACGCAGACCTCCACCGCGGAGACTCTTTTGTGCTCCAGCGACAGGCCATAACCACAGCAGATGGAGAGAGAGAGGAGGAGACGGAGGAGGAGGGAGGAGAAGCTGGAGGTAGACGAC	GCC	GAGCCACCGGCTGCTCCCTGCGCTCTCCGCGGCTGCGGGAGGGGGAAGGGAGGGGCCGCCGCCGCCCGCGCGCGCTCCCTCCTCCCTCCTCCCTCCGGCTCGCCTGCTCCCACCCCGGGCGGTGCGAGAGCCCCACGCGGGGCGGCCCTCCTGGGGGCAAGGGCAAGGAGCTCGCGCGCCAGCGCGAGACGAGAGGGTGG
FAME1	ACCAGCCTGACCAACATGGTGAAATCCCGTCTCTACTAAAAATACAAAATTAGCTGGGCGTGGTGGCACATGCCTGTAATCCCAGATACTCAGGAGGCTGAGGCAGGAAAATTGCTTGAAACTGGGAGGCGAAGGTTGCAGTGAACCCAGATCGCGCCATTGCACTCCAGCCTGGGCAACAAGAGTGAAACTCTGTCTCA	AAAAT	TAAAAATGAACAAAATGAAAAGGGGGATACTAAGAATGGAAGTATTATTTCAGAGAAGGATAAGGATAGAAGGCTTTATTCTTGTCTGGGGCTCAAGACTGGACCAATGGCTGCACAACTTTAGAGTCCATTCACAGTGTAGTCTATGCACATGGTACCTTCTAGAATTGGCATGTAGAAATTCTGATACAATGGGAGGC
ALS.FTD	AAATGCGTCGAGCTCTGAGGAGAGCCCCCGCTTCTACCCGCGCCTCTTCCCGGCAGCCGAACCCCAAACAGCCACCCGCCAGGATGCCGCCTCCTCACTCACCCACTCGCCACCGCCTGCGCCTCCGCCGCCGCGGGCGCAGGCACCGCAACCGCAGCCCCGCCCCGGGCCCGCCCCCGGGCCCGCCCCGACCACGCCCC	GGCCCC	TAGCGCGCGACTCCTGAGTTCCAGAGCTTGCTACAGGCTGCGGTTGTTTCCCTCCTTGTTTTCTTCTGGTTAATCTTTATCAGGTCTTTTCTTGTTCACCCTCAGCGAGTACTGTGAGAGCAAGTAGTGGGGAGAGAGGGTGGGAAAAACAAAAACACACACCTCCTAAACCCACACCTGCTCTTGCTAGACCCCGCCCC
FA	ACTTTGGGATTGGTTGCCAGTGCTTAAAAGTTAGGACTTAGAAAATGGATTTCCTGGCAGGACGCGGTGGCTCATGCCCATAATCTCAGCACTTTGGGAGGCCTAGGAAGGTGGATCACCTGAGGTCCGGAGTTCAAGACTAACCTGGCCAACATGGTGAAACCCAGTATCTACTAAAAAATACAAAAAAAAAAAAAAAA	GAA	AATAAAGAAAAGTTAGCCGGGCGTGGTGTCGCGCGCCTGTAATCCCAGCTACTCCAGAGGCTGCGGCAGGAGAATCGCTTGAGCCCGGGAGGCAGAGGTTGCATTAAGCCAAGATCGCCCAATGCACTCCGGCCTGGGCGACAGAGCAAGACTCCGTCTCAAAAAATAATAATAATAAATAAAAATAAAAAATAAAATGG
HSAN8	AGCCAGTCGTCCACGCTGCGCAACCACGTGCGCCTGCACACGGGCGAGCGCCCCTACAAGTGCCAGGTGTGCCAGAGCGCCTACTCGCAGCTGGCCGGCCTGCGCGCCCACCAGAAGAGCGCGCGGCACCGGCCGCCCAGCACCGCGCTGCAGGCACACTCGCCCGCGCTGCCCGCCCCGCACGCGCACGCGCCCGCGCT	CGC	CGCGCACCACCTGCCGGCCATGGTGCTGTGAGCGCGCCCGCGCCCCCGCCGGGCCCCGCGCGCTCCTGGGTCCCCGGCACCCCGGCCCCGCAGCGCGACTCGCCCTCCAGCCCCAACCCCCGGCCCGGCGCCGCCGCGGAGCCCCGCGCGCTGGGGTTGCGCCCCGGAGGCGGATCTCAGGCACCCCCGCCTTGGCCCGT
OPML1	CGCAGCCCGAGTTTCCCACCTTTTATCCTGGCCCAGACGCGGCTGGGGCGGACGGGACCTCTCGCGCTCTGCCTCCTCCTCTTGCTTCATGGAGCCATGCGCCTGGGTGGGGGCTCCCGAGAGAAGCTGGCCTGCGGGCGGGCCGGACGCGCTGCGCGGACGGGACGGGGCGAAGGAGGCCGGCAGGCGGAGGAGGAAGC	GGC	CGGGAAGAACTAGAGGTATTCCCCGGGCGGCTGGAGGACTGAGTCGAGCCGGGACCCGAGTCCTCCGGTATCCCAGCAGCCACCGGAGGCAGTGAGGTAATGGAGGAAGAATGTAGGGAGTCCTCCGGTGGACCACACTCCTTCTAGCGAGCCGCGGAAACCATAGAGATCAGGGCTCAGCCGGAGGGCCGGCCCACTGC
FRA11B	CGAAGCCGGTGGCCCGGGGATCGTCGCTGCCCAGTCCGGCCGCGGCCGGCCGCTTCCCCGAGCTTACCAGTAAGCCGGTCCGCCTCCGGGACGCGCCCCGCCCGCCCCGGGCTCGCGCGCTCTGAAGGGGCGCGTCCCGCGCACTCCCGGCGCCGCCCACTCCCCTCCCCACGGCCGCTCCTCCCTCCGCCCGGATAGCC	GGC	CGGGAGAGGCCCCTCCTTCACGCCCTGCTTCTCTCCCTCGCTCGCAGTCGAGCCGAGCCGGCGGACCCGCCTGGGCTCCGACCCTGCCCAGGCCATGGCCGGCAACGTGAAGAAGAGCTCTGGGGCCGGGGGCGGCAGCGGCTCCGGGGGCTCGGGTTCGGGTGGCCTGATTGGGCTCATGAAGGACGCCTTCCAGCCGC
DRPLA	GCCTCTCTGTCTCCAATCAGCCCCCCAAGTATACTCAGCCTTCTCTCCCATCCCAGGCTGTGTGGAGCCAGGGTCCCCCACCACCTCCTCCCTATGGCCGCCTCTTAGCCAACAGCAATGCCCATCCAGGCCCCTTCCCTCCCTCTACTGGGGCCCAGTCCACCGCCCACCCACCAGTCTCAACACATCACCATCACCAC	CAG	CATCACGGAAACTCTGGGCCCCCTCCTCCTGGAGCATTTCCCCACCCACTGGAGGGCGGTAGCTCCCACCACGCACACCCTTACGCCATGTCTCCCTCCCTGGGGTCTCTGAGGCCCTACCCACCAGGGCCAGCACACCTGCCCCCACCTCACAGCCAGGTGTCCTACAGCCAAGCAGGCCCCAATGGCCCTCCAGTCTC
FRA12A	TGGTAAAGCCGACAGTCCATACCATGAGCCCATTTCGCGCAGGGAAATTCGAGTGGTGGGCTTGGGCCCGTCGTTCTGGTAGCTTCCCAGTAGAGGGCGCCGTAAGCATATGCGTCTTCAGCCTGACTGGGCTGGAGAGGCGGTGCGTCCTCCTGGCCGGGGGGCGGGGGCCGTCGCGCTCACGTGACCTTTGCTCATGG	CGG	TGCTGGTGGTGCTCGGCGGCCGGAGCCGGATCCTGTAGCCGGGTGTGGGCCCGTGTCTGTCCGTCCCTCCTTCGGCCCCCTCTCTTGTCTTCCGGAGTGTGGCTGGCGGAGCTGGGATGGCGGAACGAGGCCTGGAGCCGTCGCCGGCCGCGGTGGCGGCGCTGCCGCCTGAAGTGCGGGCGCAGCTGGCGGAGCTGGAG
SCA2	CGGAGCGGAGGGGGCTGGGGTGCCGACACCCACCTGCCCAGGCCGGGCCTCCCGCCGCCGGAGGTCGCCGCGACCACCGAGGAGGGAGCCGTGGCCGAGGACGAGGAGACCGAGGACGAGGACGGCGAAGGCGCGGCGGCGGGCGACGCTAGAAGGCCGCTGCCGCCGGGCTTGCGGACATTGGCAGCCGCGGGCGGCGG	CTG	GGGCTTCAGCGACATGGTGAGGGGCCCATACACCGGCTCGCACGCCGGGCGGGGACAGCCGGGAGCCGGGCGCGCCAAGGAGACGCCGGAACGCGGCGGGGACGCGCGGGCGCCGAGCGGGGAGGCGCGGGTTGGCGCGGCCGGAGGGGCGCCCGGGCTGGCGAGGGGGAGAAGGAGGACGACGAAGGGGCGGGGAGGCC
SCA8	ATTCTATAGTCTGTGTCTGATATTCTCTACTATTTCCTCATTTGTCCTTGCATTCAGATTGCCTTTTCTGACTCCCAGCTTCCACGGAGAGATTAACTCTGTTGGCTGAAGCCCTATTCCCAATTCCTTGGCTAGACCCTGGGTCCTTCATGTTAGAAAACCTGGCTTTACTACTACTACTACTACTACTACTACTACTA	CTG	CATTTTTTAAAAATATATTATCTTATTTTACTATTTGATGTTATAATTGTTATATATTTTTCCACACTTCCTCATACTGCTTATCTCTTACTTAAGAATTTATGAATAAAGAATTGATTTTTCAATACATCCTTCCAAAAATTATCTGATGTTGAGTTAGTTGCTCTCTCTTGTGCATTCTCAGTCCTCACAAGCCTTTC
HPE	AGGGGCCCGGCCCCACAGCAGCTGCACTCACACCCAGTCCCCTCTGGTCCCCCCTCCCGGCTTTTGTCTTGCAGGTCCATGAGTCCTCCCCGCAGGGCTCTGAATCCTCCCCGGCCGCCAGCTCCGGCTATGAGTCGTCCACGCCCCCGGGGCTGGTGTCCCCCAGCGCCGAGCCCCAGAGCAGCTCCAACCTGTCCCCA	GCN	GTGTCCGCGGTGCACCGGGGCGGAGGCTCGGGCAGTGGCGGCGCGGGAGGCGGCTCAGGCGGCGGCAGCGGCAGTGGCGGGGGCGGCGGCGGGGCGGGCGGCGGGGGCGGCGGCAGCTCTGGCGGGGGCAGCGGGACAGCCGGGGGTCACAGCGGCCTCTCCTCCAACTTCAATGAATGGTACGTGTGACGGGTCGGGGC
SCA27B	ACTGGAGTAACTGTGGCTGTCTTGTCACCACTGTATCCCTAGTGTCTGCTGGCTAAAGAGATGAGAAAACAGAAAATATTTCTTTCCAGAGAGCAAATGACAGCAATCGTCAGTCAGTGTAAGCTTGCCTTTGCAAATGAAGGAAAACTCTTATCTTAGTTGTAAAATATCAATATTCTCTATGCAACCAACTTTCTGTG	AAG	ATGTGTTTAAGAATTCCTCAATAAGACTAAGCTCTATGTGGGCAGGAACTGCTTAATTCATCATTGCGTTCCCAATATAGTGCGCCTAGAAGATAATTAAAAAAAAAAAAAAACCTGGAGAATGAGTGAATGACATTGCTCACTATATGGACCTAAATTTAATCTCTTTATCAAGGAAAATTATAACTGTTTTCTTTTTT
OPMD	GGCAGATTTCCCCTACCGGGATTTGAGAATTTGGCGCAGTGCCCCGCCTTAGAGGTGGGGCCTTATTTGATTGCCAAGTAATATTCCCCAATGGAGTACTAGCTCATGGTGACGGGCAGGCAGCTTGACTAATGAGTCCTCGGCGTGGCCGGCGCAGCTCTCCAATCGCCGGGCGGCGGGCCCCAGTCTGAGCGGCGATG	GCG	GCAGCAGCAGCGGGGGCTGCGGGCGGTCGGGGCTCCGGGCCGGGGCGGCGGCGCCATCTTGTGCCCGGGGCCGGTGGGGAGGCCGGGGAGGGGGCCCCGGGGGGCGCAGGGGACTACGGGAACGGCCTGGAGTCTGAGGAACTGGAGCCTGAGGAGCTGCTGCTGGAGCCCGAGCCGGAGCCCGAGCCCGAAGAGGAGCC
SCA3	ACTTAAGATTCTTAATATGATTAAAGAGGGAATGAAGAATAATGTAAAGCAAAAATCACATGGAGCTCGTATGTCAGATAAAGTGTGAAGGTAGCGAACATGATGAATGGTGAGCAGGCCTTACCTAGATCACTCCCAAGTGCTCCTGAACTGGTGGCTGGCCTTTCACATGGATGTGAACTCTGTCCTGATAGGTCCCC	CTG	CTTTTGCTGCTGTCTGAAACATTCAAAAGTGAAGTATATTTAAAAAACAAAACTTAAAAGAATAAATACACCATGAGAAAAACTATTCATAAGGAAAATACATTGTTTCACGAATCAAAGTAGTCACTGGTATTAAAAGAATGCAAGAGCAGTTAGTCTGATACAGATTACTTTAAAATATGGAAGTGCTGATCTTAGGA
ALS	TGCTGTCCCCGCAGCCTAAGGCGCCGGTCCCTGGCACCCCCGTCCCGCCCCCGCCCCTCTTCCTGCTCCTCCCCCACCCGTCCCCCTCCCCTCCCCCGCCCGCGCCTCCCGGTCACCCCCCATCCCGCCCCGCGGGGCGCGGCGCGCAGGCGCAGGCTCGGAGGGCGGGCGCGGGCGGAATGGGGACTGCAGCTGCGGCA	GCG	GCCGGGGAGGGGGCGCGTAGCCCGAGCCCCGCCGCCGTGTCGCTCGGCCTGGGCGTGGCCGTCGTGTCGAGCCTGGTGAACGGGTCCACGTTCGTGCTACAGAAGAAGGGCATCGTGCGTGCCAAGCGGCGAGGTAGGGCGGGCGGCAGGCGGCAGGCGGCGGGCGGGTGGGGGAGGCGGGCGGCGGAGAAGGCGGTCGC
FAME6	GGTGTGAGAGAGGGGTAAGGGTCAACCAGGTGGCGTGTGTGAAGGCCTTGAGGAGGGCAAGGGCTCAAGAATGCTGGTGGACCAAACACATTGCATGTTTCAGACTGTGTTAGATGAGGCCATCCAGATTATGTGGAGCTCCAAAGCCCTGGCTAATGACTTGGATTTCATCCTGGGATCAATGAGCAACTATTAAAGCA	TTTTA	TTTACTTATTTATTTAGAGATAGAGTCTTGCTCTGTCGCCCAGGCTGGAGTGCAGTTGTTCGATCTCGGGTCACTGCAACCTCCGCCTCCCAGGTTCAAGCAATTCTCCCACCTCAGCCTCCTGAGTAGCTGGGATTACAAGTGTCTGCCACCATGCCCAGCTAATTTTCTTTTTTTTGTATTTTTAGTAGAAACGTGGT
SCA31	ATGGTGAAATCCCATCTCTACTAAAAAAAAAAAAAAAAAAAAAAAAAAAAATTAGCCAGGCATAGTGGCACATGCATGTAGTCCCAACTACTTGGGAGGCTGAGGCAGGAGAATCGCTTGAACCCAGAAGGTGGAAATTGCAGTGGGCCAAGATCACGTCACTGCACTCCAGCCTGGGCAACAAAACAAGACTCTGTTTC	AATAA	AAAGAAACCTCTAAATTGATTGAGATCTGCCTCCGACACTTTTCAATTTACAAAAACATACCTAAGAATTGGCCACCCAGGGGCAGGAAGCTGGGGTTTCTATCCAGTAACTCTCACCCCGCTGGCCCTTGGTTGGTTGAGGGTCGCCACCTTCCTGGCGCTTCCAGCCTGTCCCGCACACTAGCAGAGTATGCCTCTGC
HDL2	GGTGGTTGGACGCGGACTAGCGCTGTCGAAGCAGGCTGCTGGAGGGAGGAGGGAGGCCCATCTGCTCAGTGAGAGCCCAGGAATCTCGTCTTTCAGTGGCTGCATCGTTTTCACCATTAGTTGAGGGAATCGATCTGTGCCTTCATTCTAAGATGCCACCGCATTCGGGGCAGAGCCGGGGCCGGAAGCCAGGGAGCTGC	CTG	TAAGATGGTTTCTGTGCAGGGAACCTTGGCCGGCTCTGCAGCTGCCCGCCTGCCTGGACTCTCCGATATCCACTCCTCAGTGCACCTGACACGCATGGAGCCGGTCCTTTCCTGGAAGCCAGACCCCAAACAAACTGGCTTCCCCGACCAGTCCACTCCCATGTGGGAGCTTATCCTCAGAGGCACTGGGTCCTCTGCCT
RCPS	ATGCCCCGCAGCAGGTCCTCCCGCAGGCCCATGGTGTCGAACGTGGGGGTCACATCCACCTCCTCGCTGGTCTCGAATTCCACTTTAGTCATGTCTTCCTCTTTGAGCAGCCGCTTTCGCGCCGAGCCCGAGGTCGCCATCGTGGCCGTGGTCGCCATGATTCAGAGTCCGCGGAAGAGCACAGCGCGCGCCGCTGCCGA	CCTCGCTGTGCCGCTGCCGA	GAACAGACGCCTTAAGTATGCGAAAGCGAGAGACGTGCGTGCGTACGTGCGTACGTGCGTACGCGCGACGCGGCCACGCCTCTGGGGGACGGGGCACTCTTCGTCACGTGAAAGGGAACTGGGCGTTTGCCGCAGGGAAAAGTAAGGTGTTTCTGCTCTCGCGCCATATGCAGTTCCCGCGGGATCTCGTTGAGGGCGGG
FECD	CTAGTGGATAATGCACACCTTCCCTGAGTCAGAGCCTGCAAAAAGCAAAGGAACGAATGGAGAAAGTGCAACAAGCAGAAAGGGGGCTGCAAAGCTGCCTGCCTAGGGCTACGTTTCCTGGCAAAACTTCCGAAAGCCATTTCTCCAAAAGAAGGTCTAGAAGAGGAGGAGGAGGAGGAGAAGGAGGAGGAGGAGGAGGA	GCA	TGAAAGAGCCCCACTTGGAAGGCGGTTTGGATTTTATTTGTGTGTTTTGTGGATTCTTTTTATTTTGCTTTACAAATGCATCTTACACCAAACTCATCTGGCATTAAAAATGAATTCATTCTCCTGACATGTCTGGGACTTGGTTTAGGAAAAGGAAGCAAAGGGATGGAGAAGGACCAAGTACAGCCGTAAAACTCCAC
SCA6	GCCGGCCACCGGGCCCCGCCGTGTCGACAGGCCCTGGGGGACTCGCTCCGGGCCGGGCCTGGGACCCGCCTCTCCATCCTGGGCGAGCGGCCGCTGCTGTGGCCCCCCGTGGGCGGCCGATCTCCGGCCAGAGGCTCGGCCGTGGGGCCTGGGTACCTCCGAGGGCCGCTGGTGGCCGCCCGGCCCGGCCTGGCCACCGC	CTG	CGGGGGCCCCGAGCCGCCGGCCTTACGGATCACAGGGGAATAGGACACGTGTGGCCGGGGGGTGGAGGGGGTCTGGGGGAGCTGGCGGCGGCCCCGCCGCGGAGTGCTGGTACCAGATGTTGAGGGGGCTGGGCTTCCACTTACGGAACTACTGCCCTACACGAAAATTGAAACAAAGGAAATCAAAAAAAAAGATACAA
OPDM2	AGGAAGGGAGCTGCCCCCACCACCCCCCACCCCCGCTTCCCCTGGGAAGGGGCCTCCGGCATCCCCGCGCGCAGCCTAGACCTCCAGTCGCGTCCACGGCGCCGGCCCCACCCTGCAGGATCGGCCGGATCCTCGCAGGCCCGCGACCCCCGAGGCCCCCGGAGCAGACACATCCTTCTCGCAGAGGCCACTCACCTGCT	CCG	CTGCCTCCGCCTCCCCGTGCGCACCCGGCTCGGCCCTCCGCAAACTCCAGACCGGGCCTCTCCCGCAGCGGCGCCTGGGGGGCGGGGCCGACGCCCGCGGCCGGCCAATCAGCGGCTGCCTCTCGGTGCTCGCAGCCAATCCGCGTCTTCCGCTTCGGGTGGACCCGACGGAAACATTCCAGAGGGATCCCTCCGCCTCG
PSACH.MED	GTCGCCCACGCCGTCCCCTGAGAGGTGGGAGACCCCTCGGTGGGCTAAAGTCAGGGCCCGCCCACCGTAGACCCCGCGCCAGGAGCCCCCACTGGCCCCGCCCCCACCGCAGGCCCCGCCCCCGCCGTACTGTCCGCGTCCTCCTGGCCGGGGTTAGGCACCAGGCGGCAGTTGTCCCGACTGTCAGGGACTCCGTCATT	GTC	GCAGGCATCACCCTGGCCATCGTGGTCTGAGTCCTCCTGGGCACTGTTAGGCACCGTGGGACAGTTGTCCCGAGAGTCCTGATGTCCGTCTCCATCCCTAGAGTGGATAGGTGGGATCCAGAGACAATGAGCTCTCCAGAGCGTTTTGTCAAAGGCTACCCGGACGCCCACCCCAGGTGGCCTCCTTACTGGTCTTGATC
DM1	GGCAGAGATCGCGCCAGACGCTCCCCAGAGCAGGGCGTCATGCACAAGAAAGCTTTGCACTTTGCGAACCAACGATAGGTGGGGGTGCGTGGAGGATGGAACACGGACGGCCCGGCTTGCTGCCTTCCCAGGCCTGCAGTTTGCCCATCCACGTCAGGGCCTCAGCCTGGCCGAAAGAAAGAAATGGTCTGTGATCCCCC	CAG	CATTCCCGGCTACAAGGACCCTTCGAGCCCCGTTCGCCGGCCGCGGACCCGGCCCCTCCCTCCCCGGCCGCTAGGGGGCGGGCCCGGATCACAGGACTGGAGCTGGGCGGAGACCCACGCTCGGAGCGGTTGTGAACTGGCAGGCGGTGGGCGCGGCTTCTGTGCCGTGCCCCGGGCACTCAGTCTTCCAACGGGGCCCC
SCA36	AAGGCCGGAGATGGTGTCGTCCCCGGCCTCCGATTGGTCGGGGGGGCGGGGGCGTGGCCTCTGGAGCCTGGTTCCGCGCGCCGGAGCGCGCTAGCCGCATTGCGAGCCGAACCCGGGAGCTGGCGCCATGGTGAGGAGTGGTTGCGGGGCGCGGGCGACGCGACGGTGGGGGTTTCGGCCTGCGTTCGGGCCGCAGACAG	GGCCTG	CGCCTGCGCCTGCGCCTGCCCTGGGAACGGGTTCCGGCAGACGCTGAGGTTGCGTTGACGCTCGCGCCCCGGCTCCCGTTCCAGGTGCTGTTGCACGTGCTGTTTGAGCACGCGGTCGGCTACGCGCTGCTGGCGCTGAAGGAAGTGGAGGAGATCAGTCTGCTGCAGCCGCAGGTGGGTGAGATCCGTGGGCTCCTTTG
EPM1	CGTGGCGGAGGGCGCCCCGCACATCATCTTGGCGGCGACGGAGGGAATCTGGCGAGGGGACTCGGCGAGGGGACGCGGCGGCTCCTCAGCCCAAGTAGGCGCTGGGGTCACGTGACGCGCGGGCGGAACCAAGGGGCGGGGAGGAGGCACTTTGGCTTCGGAGTCCCCTGCGGGGTCGCGGTGGCCCCGCAAGAAGGGAC	GCGCGGGGCGGG	GAACCTGGCCACCACTCGCCGCAGGCTGGGTCTCCGCGCCCAGCGCTGGTGTCGGGAGGGAGCGCCCCCCTCCCGGGGCTGGTATCGTCTTTCCGGGCGCCGAGTCACACGGACCGGGGCGGGGGCGCGGCCGGGTGTCGCCGGTGGGTTGGGCGCGCAGGGTGGGACGATAGGGAAGGGGCAGTCGGAGTAGGCGCAATC
TOF	CCCCGAACCCCGAGCTGCGCCTGGAGGCGCCCGGCGCATCGGAGCCGCTGCACCACCACCCCTACAAATATCCGGCCGCCGCCTACGACCACTATCTCGGGGCCAAGAGCCGGCCGGCGCCCTACCCGCTGCCCGGCCTGCGTGGCCACGGCTACCACCCGCACGCGCATCCGCACCACCACCACCACCCCGTGAGTCCA	GCC	AACATGTACTCGTCGGCCGGAGCCGCGCCGCCCGGCTCCTACGACTATTGCCCCAGATAACACGGGCCCTGTCGCGCTCCCGCCCCGGTCCTGCACAGCCCCGAAGTTCGCCGGGCCCGGCCACCCTGCCCCAAGGGCAAGCAAGGAATACGTTCCCCCAGCCCCAGGGGCCACCGCGGCTCTCCCCTTCCCCAGCCTCG
SCA10	AGAGAGACAGTTAACAAGCCAGTATTGGAGAAATAAGTGGAATATTTAAAAATGCTCAGTCTCAAAAGAGTCTGGAAAATAAGAACAAAGAATAGTGAAGACAAATAGAAAACAGATGGCAGAATGATAAACTCAATCATGTTGATAAATATATTAAATGTAAATGGCTTAAATATCCAACTAAAAGACTACTAGAATGG	ATTCT	TTTTGAGATGAAGTCTCTCTATGTTGCCCAGGCTGGAGTGCAGTGGCGCGATCTCAGCTCACTGCAACCTCTGCCTACCAGGTTCAAGCAATTCTCCTGCCTCAGCCTCCCAAGTAGCTGAGATTACAGGTTCACCACCACACCCAGCTAATTTTTGTATTTTTAGTAGAGACGGTGTTTCGGGAAGTCAGGGACCCTGA
XLID	AGGGCGCCCCGTTCTCGCGGTACGACTTGCTGCGGCTGATGCTCACCTGCGGCGCCTGGCTGATCTTGAGCGTGTCCCAGGCCGCGGCGGCCGCGGCCGCGGCTGCCGCGGCGGCCCCTGCGCCGTCCGGCCGTTCCCCGGGCCGCGCGGTTGGCGGTGGCGGCGGAGGGGCCTCCCCGCGTGGACCCGCCGTGGCCGTG	GCC	GCACCCTGAAGGAGGCGGCCCCCGCCCGGGCCGTACAGGCGCCGCAGCTTGGGCGGCAGGTGCAGCTCGGCCTCGAACGGGGCGCTGCTGCTCTTAGGGGAGCCTGCGGGCAAGGGAGAGCTATCAGCCAGCCGGCCGGCCGGGGAGTCCCAGCCAGGGCTGCTGCCGGGGCCCGCCCGCAGTTGCTCCCCCAGTGCCTA
DMD	AAGAATCCTTGGTGATAGGATCTTCAGACAGAGAGGCTCTAGGGACTTGAAACCTGGAAGTTCAGCATAGGCATTTAGTATATGTTGAGCCTTAGGGAACTCATTTATCAATTTGATATCACTCCTTTGTATCACTGCCATGGTGAATGATCAGAAAGGAAACACAAACTCCTTCTTTAAGAACTGCAATAACGAACTGT	TTC	TTTTTTTTGGCAGAGGTGGGGTGTCTCGCTACCTTGACTAGGCAGGTCTTGAACTGCTGGCCTCAAGCAATGCTCCCACCTCAGCCTCCCAAAGTGTTCGGATAACCGGCATTAGCCACCTCCTCTGGCCAAGAACTGTTTCTTTTGATTAAATTTTGTTCTTCCTACTCCAACTTTCCTTAAAGATAATGCTTCCTTAA
SBMA	AGTAGGTGGAAGATTCAGCCAAGCTCAAGGATGGAAGTGCAGTTAGGGCTGGGAAGGGTCTACCCTCGGCCGCCGTCCAAGACCTACCGAGGAGCTTTCCAGAATCTGTTCCAGAGCGTGCGCGAAGTGATCCAGAACCCGGGCCCCAGGCACCCAGAGGCCGCGAGCGCAGCACCTCCCGGCGCCAGTTTGCTGCTGCT	GCA	AGAGACTAGCCCCAGGCAGCAGCAGCAGCAGCAGGGTGAGGATGGTTCTCCCCAAGCCCATCGTAGAGGCCCCACAGGCTACCTGGTCCTGGATGAGGAACAGCAACCTTCACAGCCGCAGTCGGCCCTGGAGTGCCACCCCGAGAGAGGTTGCGTCCCAGAGCCTGGAGCCGCCGTGGCCGCCAGCAAGGGGCTGCCGC
XDP	TGGAGACCAGCCCGGCCAACACAGCGAAACCCGGTCTCCACCAAAAAAATACGAAAACCAGTCAGGCGTGGTGGCGCGCGCCTGCAATCGCAGGCACTCGGCAGGCTGAGGCAGGAGAATCAGGCAGGCAGGTTGCAGTGAGCCGAGATGGCAGCAGCACAGTCCAGCTTCGGCTCGGCATCAGAGGGAGACCGTGGAAA	GAGAGG	AGGAATTCTGTCTTACTCCAGACCAGTTGGTTTGTTTTTAGAGCAGCTTTAGTTCATGGCAAAATTGAGCAGAAGTTACAGAGAGTTCCCATATACTCCCTGCCCTCACATACATACAGCCTCCCCAGTTATCAACATCTTGCACCAGGCTGGGCGTTGTGGCTCACGCCTGTAATCCCAGCACTTTGGGAAGCCAAGGT
XH	GCGGCATCATTGGGCTGTACTGCAGGCCGGCCATGTCGTAGCGGTGCATCGGCGGCAGCGCGGGCGGCGGCGGCGGGCTGCTCATGCTCGGGGGCTGCGCGTAGCCCAGCTGCTCCTGCACCAGCGAGTACGCGCCGTTGGCCCAGCCGTTCACGTGCGTGTACGTGTCCAGGCGCTGGCCCACGCCCACCGGACTGCTG	GCN	CCGGGAGGCAGGAGGCCGCTGGGCAGGGAGTACTTATCTTTCTTGAGCAGCGTCTTGGTCTTGCGGCGCGGTCGGTACTTGTAGTCCGGATACTCCTTCATGTGCACGGCGCGAAGTCGCTTGGCCTCGTCGATGAATGGTCGCTTCTCGGCGTCGGTCAGCAGTTTCCAGTCGGCGCCCAAGCGCTTGCTGATCTCAGA
FXS	GGAGGGAACAGCGTTGATCACGTGACGTGGTTTCAGTGTTTACACCCGCAGCGGGCCGGGGGTTCGGCCTCAGTCAGGCGCTCAGCTCCGTTTCGGTTTCACTTCCGGTGGAGGGCCGCCTCTGAGCGGGCGGCGGGCCGACGGCGAGCGCGGGCGGCGGCGGTGACGGAGGCGCCGCTGCCAGGGGGCGTGCGGCAGCG	CGG	CTGGGCCTCGAGCGCCCGCAGCCCACCTCTCGGGGGCGGGCTCCCGGCGCTAGCAGGGCTGAAGAGAAGATGGAGGAGCTGGTGGTGGAAGTGCGGGGCTCCAATGGCGCTTTCTACAAGGTACTTGGCTCTAGGGCAGGCCCCATCTTCGCCCTTCCTTCCCTCCCTTTTCTTCTTGGTGTCGGCGGGAGGCAGGCCCGG
FRAXE	TCCCACTAGCTGATTTTGACAGTGGGGGGTGGGAGAGGGTTCCCGAAAGGCAGGGGCGGGCGCGGCGAGCCCCTGCCAGATCCGGGGATGATAACGTGCCTGCTCCATGTCGCGGCTTCTAGCTGTCCAGGCTCCGCCCCCTGTGAGTGTGTAAGTGTGTGATGCTGCCGCGGCCGCCGCCGCCGCCTGTGCAGCCGCTG	CCG	CTGCCGCCCCGGCTGCCGCGCCGCGCCGCTGCCTCTGCCCCGGCCGCCCCCGCCGCCGCTGCCGCCGCCGGCCCGCAGCCAGCCAGGCGGGCGGCCCAGCCCGCCTGAGCCCGCAGCGGCTGCCGCCGCAGCGTCGGGTCGCTGGGTGCGCGGGCTACCGCGGACCGAGCGGACCCGAGTGGGCGACCAGGCGCTTGCCC
BSS	GTCTGCAGCAGCAGCGCCGTAAGCACCGACAGCGCCGAGTGCGAGCGCCGGGCCAGCCTCCAGGCGCGCCGGCGCCGCCCACCATCTTCGGAGCGCGCGCGGCGGCGCCGGGGACCCGGCACGCTCCGGGCCGCCCGCGCTCCGCAGCTCCGCGGCCGGCCAGCTGCCGCTCGGGCTCCCGCTCGGGCCGCCGCCGCCGCCGCCGCCTCGGCTCGCCGCTGCTCCT	CCG	CCTCCACCGCCGCGGCGCGGAGTTCAGACGGGCAGGGACCCGGACGTCACCAGGAGGAGGAGAAGGCGGGAGGCGGGAGCGGGGGAGGCCGCGGAGGGGGGCGCCGGGCGCGCGCTCGGGGACGGGGCGCGCAGGGGAGGGGCGCCTGGCCCGCGCGG
SCA27B_CCCC	actgtggctgtcttgtcaccactgtatccctagtgtcTGCTGGCTAAAGAGATGAGAAAACAGAAAATATTTCTTTCCAGAGAGCAAATGACAGCAATCGTCAGTCAGTGTAAGCTTGCCTTTGCAAATGAAGGAAAACTCTTATCTTAGTTGTAAAATATCAATATTCTCTATGCAACCAACTTTCTGTTAGTCATAGTACCCC	AAG	AATAGAAATGTGTTTAAGAATtcctcaataagactaagctctatgtgggcaggaactgcttaattcatcattgcgttcccaatatagtgcgcctagaagataattaaaaaaAAAAAAAAACCTGGAGAATGAGTGAATGACATTGCTCACTATATGGACCTAAATTTAATCTCTTTATCAAGGAAAATTATAACTGTTTTCT
SCA27B_GTG	actgtggctgtcttgtcaccactgtatccctagtgtcTGCTGGCTAAAGAGATGAGAAAACAGAAAATATTTCTTTCCAGAGAGCAAATGACAGCAATCGTCAGTCAGTGTAAGCTTGCCTTTGCAAATGAAGGAAAACTCTTATCTTAGTTGTAAAATATCAATATTCTCTATGCAACCAACTTTCTGTG	AAG	AATAGAAATGTGTTTAAGAATtcctcaataagactaagctctatgtgggcaggaactgcttaattcatcattgcgttcccaatatagtgcgcctagaagataattaaaaaaAAAAAAAAACCTGGAGAATGAGTGAATGACATTGCTCACTATATGGACCTAAATTTAATCTCTTTATCAAGGAAAATTATAACTGTTTTCT
SCA27B_GTGG	actgtggctgtcttgtcaccactgtatccctagtgtcTGCTGGCTAAAGAGATGAGAAAACAGAAAATATTTCTTTCCAGAGAGCAAATGACAGCAATCGTCAGTCAGTGTAAGCTTGCCTTTGCAAATGAAGGAAAACTCTTATCTTAGTTGTAAAATATCAATATTCTCTATGCAACCAACTTTCTGTGG	AAG	AATAGAAATGTGTTTAAGAATtcctcaataagactaagctctatgtgggcaggaactgcttaattcatcattgcgttcccaatatagtgcgcctagaagataattaaaaaaAAAAAAAAACCTGGAGAATGAGTGAATGACATTGCTCACTATATGGACCTAAATTTAATCTCTTTATCAAGGAAAATTATAACTGTTTTCT
CANVAS_path	AGCTTGGCCAATATGGTAAAACCCCATCTCTAGGAAAAATACAAAAAATTAGCTGGACATGGTGGCACGCGACTATAGTCCCAGCTACTCAGGAGGCTGAGGCAGGAGATTCACTTGAACCTGGGAGGCAGAGGTTGCAGTGAGCCGAGATTGCGCCACTGCACTCCAGTCTGGGCAACAGAGCAAGACTCTGTTTCAAA	AAGGG	AAAAAGCATGTTCTAAAGAGAATAGCAACGGTGTAGCTGGAGTATCACTTGATAAAGAGATTATGGGATTATACAGGCAAAAACACTGTCAGTTTGAATTGAAGAGGATGGAGAAAGGACAAAATGAAAGAAGGCTGTCAGACTTCTGAGATTCCAGTGACAGGACAACACAGCTATTCTTCAAGAAAAGGGAAGAATGG
